{
  "map":[
    "x----------+---x",
    "|          |   |",
    "+-+ +------+ + |",
    "|            | |",
    "| +--+ +-----+ |",
    "|    | |       |",
    "+----+ +-------+",
    "|              |",
    "x--------------x"
  ],
  "playerStart": { "x": 5, "y": 14 },
  "goal": { "x": 5, "y": 8 }
}